{   
    "columns" : 20,
    "rows" : 20,
    "array2d" : [
                  [1, 3, 14, 4, 4, 4, 4, 4, 4, 4, 4, 4, 4, 14, 14, 14, 4, 4, 4, 4],
                  [1, 2, 3, 14, 14, 15, 15, 15, 4, 14, 14, 14, 14, 14, 14, 4, 4, 4, 4, 4],
                  [1, 1, 2, 3, 3, 15, 91, 15, 4, 14, 5, 5, 5, 5, 14, 15, 15, 15, 4, 4],
                  [1, 1, 1, 2, 2, 3, 3, 3, 4, 14, 5, 5, 5, 5, 14, 15, 93, 15, 4, 4],
                  [1, 1, 1, 1, 2, 2, 2, 3, 3, 14, 14, 14, 14, 14, 14, 4, 4, 4, 4, 4],
                  [1, 1, 1, 1, 1, 2, 2, 3, 3, 4, 14, 4, 4, 4, 14, 14, 4, 4, 4, 4],
                  [1, 1, 1, 1, 2, 2, 3, 3, 3, 4, 14, 4, 4, 4, 14, 4, 4, 4, 4, 4],
                  [1, 1, 1, 2, 2, 3, 3, 3, 14, 4, 14, 14, 14, 14, 14, 4, 4, 4, 4, 4],
                  [1, 1, 1, 2, 2, 3, 3, 3, 14, 14, 4, 4, 4, 4, 4, 4, 4, 4, 13, 4],
                  [1, 1, 1, 2, 2, 3, 3, 3, 3, 14, 14, 4, 4, 4, 4, 4, 4, 4, 4, 4],
                  [1, 1, 1, 1, 2, 11, 3, 3, 3, 3, 14, 14, 4, 4, 15, 15, 15, 4, 4, 4],
                  [1, 1, 1, 1, 1, 2, 2, 3, 3, 3, 3, 14, 14, 14, 15, 94, 15, 4, 4, 4],
                  [1, 1, 1, 1, 1, 1, 2, 2, 12, 3, 3, 3, 3, 14, 14, 4, 4, 4, 4, 4],
                  [1, 1, 1, 1, 1, 1, 2, 2, 2, 3, 3, 3, 3, 3, 14, 14, 4, 4, 14, 14],
                  [1, 1, 1, 1, 1, 1, 1, 1, 2, 2, 15, 15, 15, 3, 3, 14, 14, 14, 14, 14],
                  [1, 1, 1, 1, 1, 1, 1, 1, 1, 2, 15, 92, 15, 3, 3, 3, 3, 3, 2, 2],
                  [1, 1, 10, 1, 1, 1, 1, 1, 1, 1, 1, 2, 2, 2, 2, 3, 3, 2, 2, 2],
                  [1, 1, 1, 1, 1, 1, 1, 1, 1, 1, 1, 1, 2, 2, 2, 2, 2, 2, 2, 2],
                  [1, 1, 1, 1, 1, 1, 1, 1, 1, 1, 1, 1, 1, 1, 1, 2, 2, 2, 2, 2],
                  [1, 1, 1, 1, 1, 1, 1, 1, 1, 1, 1, 1, 1, 1, 1, 1, 1, 1, 1, 1]
                ]
}
