{   
    "columns" : 20,
    "rows" : 20,
    "array2d" : [
      [1, 3, 14, 14, 14, 14, 14, 14, 14, 14, 14, 14, 14, 14, 14, 14, 14, 14, 14, 14],
      [1, 2, 3, 14, 14, 14, 14, 14, 14, 14, 14, 14, 14, 14, 14, 14, 14, 14, 14, 14],
      [1, 1, 2, 3, 3, 3, 3, 3, 14, 14, 14, 14, 14, 14, 14, 14, 14, 14, 14, 14],
      [1, 1, 1, 2, 2, 3, 3, 3, 14, 14, 14, 14, 14, 14, 14, 14, 14, 14, 14, 14],
      [1, 1, 1, 1, 2, 2, 2, 3, 3, 14, 14, 14, 14, 14, 14, 14, 14, 14, 14, 14],
      [1, 1, 1, 1, 1, 2, 2, 3, 3, 14, 14, 14, 14, 14, 14, 14, 14, 14, 14, 14],
      [1, 1, 1, 1, 2, 2, 3, 3, 3, 14, 14, 14, 14, 14, 14, 14, 14, 14, 14, 14],
      [1, 1, 1, 2, 2, 3, 3, 3, 14, 14, 14, 14, 14, 14, 14, 14, 14, 14, 14, 14],
      [1, 1, 1, 2, 2, 3, 3, 3, 14, 14, 14, 14, 14, 14, 14, 14, 14, 14, 14, 14],
      [1, 1, 1, 2, 2, 3, 3, 3, 3, 14, 14, 14, 14, 14, 14, 14, 14, 14, 14, 14],
      [1, 1, 1, 1, 2, 2, 3, 3, 3, 3, 14, 14, 14, 14, 14, 14, 14, 14, 14, 14],
      [1, 1, 1, 1, 1, 2, 2, 3, 3, 3, 3, 14, 14, 14, 14, 14, 14, 14, 14, 14],
      [1, 1, 1, 1, 1, 1, 2, 2, 3, 3, 3, 3, 3, 14, 14, 14, 14, 14, 14, 14],
      [1, 1, 1, 1, 1, 1, 2, 2, 2, 3, 3, 3, 3, 3, 14, 14, 14, 14, 14, 14],
      [1, 1, 1, 1, 1, 1, 1, 1, 2, 2, 2, 3, 3, 3, 3, 14, 14, 14, 14, 14],
      [1, 1, 1, 1, 1, 1, 1, 1, 1, 2, 2, 2, 3, 3, 3, 3, 3, 3, 2, 2],
      [1, 1, 1, 1, 1, 1, 1, 1, 1, 1, 1, 2, 2, 2, 2, 3, 3, 2, 2, 2],
      [1, 1, 1, 1, 1, 1, 1, 1, 1, 1, 1, 1, 2, 2, 2, 2, 2, 2, 2, 2],
      [1, 1, 1, 1, 1, 1, 1, 1, 1, 1, 1, 1, 1, 1, 1, 2, 2, 2, 2, 2],
      [1, 1, 1, 1, 1, 1, 1, 1, 1, 1, 1, 1, 1, 1, 1, 1, 1, 1, 1, 1]
    ]
}